8 8
########
##po####
##oXoo##
###o#o##
#d#o#oo#
#dXoo#o#
#doooXo#
########